🌿🌿🌿🌿🌼🌿🌼🌼🌼🌿🌿🌿
🌿🌿🌿🌿🌿🌼🌿🌼🌿🌿🌿🌿
🌿🌿🌿🌿🌼🌿🌿🌿🌿🌿🌿🌿
🌿🌿🌿🔥🔥🔥🔥🔥🌉🔥🔥🔥
🔥🔥🔥🔥🔥🔥🔥🔥🌉🔥🔥🔥
🔥🔥🔥🔥🔥🔥🔥🔥🌉🔥🔥🔥
🔥🔥🔥🔥🔥🔥🔥🔥🌉🔥🔥🔥
🔥🔥🔥🔥🔥🔥🔥🔥🌉🔥🔥🔥
🔥🔥🔥🔥🔥🔥🔥🔥🌉🔥🔥🔥
🌿🌿🌿🌲🌿🌿🌿🌿🌼🌿🌲🌲